AAPL: Apple Inc.
MSFT: Microsoft Corporation
IBM: International Business Machines Corporation
GE: General Electric Company
KO: The Coca-Cola Company
JNJ: Johnson & Johnson
XOM: Exxon Mobil Corporation
PG: The Procter & Gamble Company
MCD: McDonald's Corporation
WMT: Walmart Inc.
T: AT&T Inc.
MRK: Merck & Co., Inc.
PFE: Pfizer Inc.
CVX: Chevron Corporation
BA: The Boeing Company
PEP: PepsiCo, Inc.
VZ: Verizon Communications Inc.
V: Visa Inc.
CSCO: Cisco Systems, Inc.
INTC: Intel Corporation
WBA: Walgreens Boots Alliance, Inc.
NKE: NIKE, Inc.
DIS: The Walt Disney Company
MMM: 3M Company
HON: Honeywell International Inc.
AMGN: Amgen Inc.
CAT: Caterpillar Inc.
RTX: RTX Corporation
GS: The Goldman Sachs Group, Inc.
AXP: American Express Company
LMT: Lockheed Martin Corporation
MO: Altria Group, Inc.
CMCSA: Comcast Corporation
DHR: Danaher Corporation
ORCL: Oracle Corporation
MDT: Medtronic plc
GILD: Gilead Sciences, Inc.
BMY: Bristol-Myers Squibb Company
COST: Costco Wholesale Corporation
TGT: Target Corporation
LOW: Lowe's Companies, Inc.
HD: The Home Depot, Inc.
SBUX: Starbucks Corporation
FDX: FedEx Corporation
UPS: United Parcel Service, Inc.
GM: General Motors Company
F: Ford Motor Company
TSLA: Tesla, Inc.
NFLX: Netflix, Inc.
NVDA: NVIDIA Corporation
ADBE: Adobe Inc.
QCOM: QUALCOMM Incorporated
AVGO: Broadcom Inc.
TXN: Texas Instruments Incorporated
AMD: Advanced Micro Devices, Inc.
INTU: Intuit Inc.
AMAT: Applied Materials, Inc.
MU: Micron Technology, Inc.
LRCX: Lam Research Corporation
KLAC: KLA Corporation
HPQ: HP Inc.
DELL: Dell Technologies Inc.
CSX: CSX Corporation
UNP: Union Pacific Corporation
NSC: Norfolk Southern Corporation
KSU: N/A
UAL: United Airlines Holdings, Inc.
DAL: Delta Air Lines, Inc.
AAL: American Airlines Group Inc.
LUV: Southwest Airlines Co.
JBLU: JetBlue Airways Corporation
SWA: N/A
XEL: Xcel Energy Inc.
NEE: NextEra Energy, Inc.
DUK: Duke Energy Corporation
SO: The Southern Company
AEP: American Electric Power Company, Inc.
D: Dominion Energy, Inc.
EXC: Exelon Corporation
PEG: Public Service Enterprise Group Incorporated
PCG: PG&E Corporation
EIX: Edison International
PPL: PPL Corporation
FE: FirstEnergy Corp.
ED: Consolidated Edison, Inc.
NRG: NRG Energy, Inc.
AES: The AES Corporation
CMS: CMS Energy Corporation
DTE: DTE Energy Company
ETR: Entergy Corporation
AEE: Ameren Corporation
WEC: WEC Energy Group, Inc.
ES: Eversource Energy
ATO: Atmos Energy Corporation
NI: NiSource Inc.
CNP: CenterPoint Energy, Inc.
PNW: Pinnacle West Capital Corporation
OGE: OGE Energy Corp.
IDA: IDACORP, Inc.
ALB: Albemarle Corporation
PXD: Pioneer Natural Resources Company
EOG: EOG Resources, Inc.
HAL: Halliburton Company
SLB: Schlumberger Limited
BKR: Baker Hughes Company
DVN: Devon Energy Corporation
COP: ConocoPhillips
XEC: N/A
OXY: Occidental Petroleum Corporation
APA: APA Corporation
FANG: Diamondback Energy, Inc.
HES: Hess Corporation
MRO: Marathon Oil Corporation
CLR: N/A
CXO: N/A
MTDR: Matador Resources Company
PSX: Phillips 66
VLO: Valero Energy Corporation
MPC: Marathon Petroleum Corporation
HFC: N/A
DK: Delek US Holdings, Inc.
BP: BP p.l.c.
RDS.A: N/A
RDS.B: N/A
TOT: N/A
E: Eni S.p.A.
ENB: Enbridge Inc.
TRP: TC Energy Corporation
KMI: Kinder Morgan, Inc.
WMB: The Williams Companies, Inc.
OKE: ONEOK, Inc.
EPD: Enterprise Products Partners L.P.
ET: Energy Transfer LP
MPLX: MPLX LP
PAA: Plains All American Pipeline, L.P.
